WE           assets/HBONEY.xpm
         SO               assets/HBRK2B.xpm


                NO 
NO assets/HBRK2B.xpm

F 50   , 50    ,   50
C 0,100 ,  100


   EA   assets/HBRK2B.xpm             

GF:123 abc

11111111111111111111111111111111111111111111111111111111111111111111111111111111111111
10000000000000000000000000000000100000000000000000000000100000000000000000000000000001
10000000000000000000000000000000100000000000000000000000D00000000000000000000000000001
10000000000000000000000000000000100000000000000000000000100000000000000000000000000001
1000000000001110000000000000000010000000000000000000000010000000000000000N000000000001
10000000000011100000000000000000D00000000000000000000000100000000010000000000000000001
10000000000011100000000000000000100000000000000000000000100000000001000000000000000001
10000000000000000000000000000000100000000000000000000000100000000000000000000000000001
10000000000000000000000000000000100000000000000000000000100000000000000000000000000001
10000000000000000000000000000000100000000000000000000000100000000000000000000000000001
100000000000011111111111111111110111111111111111111111111111111111111111111111111D1111
1000000000000D000000000000000001000000000000010001001001110000000000000000000000000001
10000000000001000000000000000000001000000000111001001001010000000000000000000000000001
1000000000000D000000000000000000000100000001000101101101110000000000000000000000000001
10000000000001000000000000000001000000000000000000000000000000000000000000000000000001
1000000000000D000000000000000001111111111D111111111111111D1111111111111111111111111111
100000000000011111D1111D111D1111000000000010000000000000000000010000000000000000000001
10000000000001000000000000000001000000000010000000000000000000010000000000000000000001
10000000000001000000000000000001000000000010000000000000000000010000000000000000000001
10000000000001000000000000000001000000000010000000000000000000010000000000000000000001
1000000000000D00000000000000000D0000000000D0000000000000000000010000000000000000000001
10000000000001000000000000000001000000000010000000000000000000010000000000000000000001
10000000000001000000000000000001000000000010000000000000000000010000000000000000000001
100000000000010000000000000000010000000000100000000000000000000D0000000000000000000001
10000000000001000000000000000001000000000010000000000000000000010000000000000000000001
10000000000001000000000000000001000000000010000000000000000000011111111111111111111111
10000000000001000000000000000001000000000010000000000000000000010000000000000000000001
1000000000000100000000000000000100000000001111111111D111111111110000000000000000000001
10000000000001000000000000000001000000000010000000000000000000000000000000000000000001
10000000000001000000000000000001000000000010000000000000000000000000000000000000000001
10000000000001000000000000000001000000000010000000000000000000000000000000000000000001
100000000000010000000000000000011111D1111110000000000000000000000000000000000000000001
10000000000001000000000000000001000000000010000000000000000000000000000000000000000001
10000000000001000000000000000001000000000010000000000000000000000000000000000000000001
10000000000001000000000000000001000000000010000000000000000000000000000000000000000001
10000000000001000000000000000001000000000010000000000000000000000000000000000000000001
10000000000001000000000000000001000000000010000000000000000000000000000000000000000001
10000000000001000000000000000001000000000010000000000000000000000000000000000000000001
1000000000000111111111D111111111000000000010000000000000000000000000000000000000000001
10000000000001000000000000000001000000000010000000000000000000000000000000000000000001
10000000000001000000000000000001000000000010000000000000000000000000000000000000000001
10000000100001000000000000000001000000000010000000000000000000000000000000000000000001
10011111100001000000000000000001000000000010000000000000000000000000000000000000000001
10000000000001000000000000000001000000000010000000000000000000000000000000000000000001
1001111110000100000000000000000D000000000010000000000000000000000000000000000000000001
10010000100001000000000000000001000000000010000000000000000000000000000000000000000001
10011111100001000000000000000001000000000010000000000000000000000000000000000000000001
10000000000001000000000000000001000000000010000000000000000000000000000000000000000001
10000000100001000000000000000001000000000010000000000000000000000000000000000000000001
10011111100001000000000000000001000000000010000000000000000000000000000000000000000001
10000000000001000000000000000001000000000010000000000000000000000000000000000000000001
10000000000001000000000000000001000000000110000000000000000000000000000000000000000001
11111111111111111111111111111111111111111111111111111111111111111111111111111111111111