WE             assets/HTEMBRK2.xpm
         SO               assets/HTEMBRK2.xpm


                NO 
NO assets/HTEMBRK2.xpm

F 255   , 214    ,   255
C 50,50,50w


   EA   assets/HTEMBRK2.xpm           

GF:123 abc

111111111111111111111111111111111111111111111111111111111111111111111111111111111111111111111111111111111111111111111111111111111111111111111111111111111111111111111111111111111111111111111111111111111111111111111111111111111111111111111111111111111111111111111111111111111111111111
100010010100000000000000000000000000000000000000000000000000000000000000000000000000000000000000000000000000000000000000000000000000000000000000000000000000000000000000000000000000000000000000000000000000000000000000000000000000000000000000000000000000000000000000000000000000000001
100000000000000111111111111111111111111111111111111111111111111111111111111111111111111111111111111111111111111111111111111111111111111111111111111111111111111111111111111111111111111111111111111111111111111111111111111111111111111111111111111111111111111111111111111111111111111111
1000000000000001
1000000000000001
10000000N0000001
1111111111111111